2003968548
2003961554
1271285420
2041357351
2053932084
1979972331
1551208351
1401067890
2025624738
2040292717
1981326041
2053911360
2003429799
2012888855
2053485314
1551563706
2003445679
1974711634
2003840446
1958638143
2003390053
2004035195
2052935933
1551430363
2053619668
1977559692
2053642438
2053706295
1102504903
1551689891
2053895295
1271218935
2004573144
2040443354
1271214174
1883442063
2003249146
2040283511
2002858307
2053455346
2042976802
1271224644
1884534545
2052900970
1201283361
1271107294
2053407395
2025643744
1551251316
1973452525
2005332194
2002845524
2001360189
2040329214
1981157786
2053948755
2053817104
118181168
2005519253
316271332
2025604761
1201186186
1551276233
1718244025
198239605
1980816129
229742116
1401068276
1271228784
2040052840
51695812
1551581457
1717843537
1969806975
2053012616
2052948386
1102562554
2053565977
1201355818
2002204894
1551736751
2003836359
2052936825
2002619632
1102567841
1958182669
2053564937
2014208546
1201254623
2040326958
1201294776
2053879086
1884412898
